111111111111111

222222222222222

333333333333333

444444444444444

555555555555555

444444444444444

333333333333333

222222222222222

111111111111111