222222222222222
000000060000000
000000777000000
000001111100000
000066666660000
000777777777000
001111111111100
066666666666660
777777777777777
066666666666660
001111111111100
000777777777000
000066666660000
000001111100000
000000777000000
000000060000000
222222222222222