135000006700000021
213500006700000213
021350006700002135
002135006700021350
000213506700213500
000021356702135000
000002136721350000
000000216713500000
777777777666666666
666666666777777777
000054317612000000
000543127631200000
005431207653120000
054312007605312000
543120007600531200
431200007600053120
312000007600005312
120000007600000531